NERLA KOTTALU	NERLAKOTALU
NADIMURU KOTTALU	NADIMURUKOTALU
JALLAPPAKOTALU	JALLAPPA KOTALU
D.BOMPALLE	D.BOOMPALLE
BANDAKINDATHANDA	BANDAKINDA THANDA
MITTAVANDLAPALLI	MITTAVANDLAPALLE
VADDIPALLE	VADDIPALLI
PATHURU THURAKAPALLE	PATHURU TURAKAPALLE
GOLLAKHANDRIGA	GOLLAKANDRIGA
AMUDALA H.W.	AMUDALA HW
VADDE INDLU	VADDEINDLU
SIMHARAJUPURAM H.W	SIMHARAJAPURAM HW
KOLLUREDDIKHANDRIGA	KOLLUREDDI KANDRIGA
PAVALURIKANDIGA	PAVALURIKANDRIGA
BALIJAKHANDRIGA H.W.	BALIJA KANDRIGA
AKANAMBATTU H.WADA	AKANAMBATTU
KAPUPALLE H.WADA	KAPUPALLE& HW
THOTAVARIPALLE MW	THOTAVARIPALLE& MW
MUDDALAIAHGARIPALLE H.W	MUDDALAIAHGARIPALLE
ERRACHERUVUPALLE	ERRACHERUVU PALLE
GODUGUCHINTA H.WADA	GODUGUCHINTA
GODUGUCHINTA H.WADA	GODUGUCHINTA HW
NALLAGATLAPALLE A.A.W	NALLAGATLAPALLE
EGUVAPALAKURU	EGUVA PALAKURU
KITCHNNAGARIPALLE H.W	KITCHENNAGARIPALLI
KITCHNNAGARIPALLE H.W	KITCHENNAGARIPALLI HW
KUPPANAGARIPALLE	KUPPANNAGARIPALLI
NADIMPALLE	NADIMPALLE 
PANTAPALLE	PANTAPALLI
VENKATRAMAPURAM	VENKATRAMAPURAM 
NADIMPALLE H.WADA	NADIMPALLE HW
KOTHAPALLE YC	KOTHAPALLE& YC
PATURU HW	PATURU
GANDLAPALLE	GANDLA PALLE
AMMEPALLE H.W	AMMEPALLE
THALUPUNENIVARI PALLI	THALUPULAPALLE
PAPINAYANIPALLE H.WADA	PAPINAYANIPALLE H.WADA 
PAPINAYANIPALLE H.WADA	PAPINAYANIPALLE 
THIMMIREDDIPALLE H.WAD	THIMMIREDDIPALLE H.WADA
THIMMIREDDIPALLE	THIMMIREDDIPALLE 
AMMAGARIPALLE	AMMAGARIPALLI
BODIREDDIKANDRIGA H.W	BODIREDDIKANDRIGA & HW
ABBIREDDIVURU H.W	ABBIREDDIVURU& HW
VEERLAGUDIPALLE A.A.W	VEERLAGUDIPALLE & AAW
VENUTHANAPALLE H.W.	VENUTHANAPALLE
BOOSIPALLE H.WADA	BOOSIPALLE HW
D.MAGHAM H.W. COLONY	D.MAGHAM H.W.
PONNEDUPALLE H.W.	PONNEDUPALLE& H.W.
GOVINDAREDDIPALLE H.W.	GOVINDAREDDIPALLE
DIGUVA MATHYAM H.W.	DIGUVA MATHYAM
THODATHORA H.W.	THODATHORA
VENKATAPURAM YC	VENKATAPURAM
E.THAVANAMPALLE A.W.	E.THAVANAMPALLE H.W.
DIGUVA MATHYAM H.W.	DIGUVA MATHYAM H/W.
MITTAMADIGAPALLE	MITTAMADHIGAPALLE
BESTHAPALLE H.W.	BESTHAPALLI
THELLAGUNDLAPALLE H.W.	THELLAGUNDLAPALLE H.W. 
MITTOOR H.W.	MITTOOR 
EGUVACHAVATAPALLE H.W.	EGUVACHAVATAPALLE&M.W
VENKATAPURAM H.W	VENKATAPURAM&HW
IRUVARAMPALLE M.W.	IRUVARAMPALLE H.W.
KUMMARAPALLE	KUMMARAPALLI
AGARAMPALLE H.W.	AGARAMPALLI
AGARAMPALLE H.W.	AGARAMPALLI HW
CHANAGANAPALLE H.W.	CHANAGANAPALLE &H.W.
MOTAKAMPALLE MW	MOTAKAMPALLE
M.PAIPALLE H.W.	M.PAIPALLE
JANGALAPALLE H.W.	JANGALAPALLE& HW
GURUVANAMPALLE	GURUVNAMPALLI
MORAMPALLE	MORAMPALLI
GAJULAPALLE M.W. U.I.	GAJULAPALLE H.W
MUDIGOLAM H.W.	MUDIGOLAM HW
MUDIGOLAM H.W.	MUDIGOLAM
NELLIMANDAPALLE MW	NELLIMANDAPALLE$ MW
KUMMARAPALLE	KUMMARAPALLI
PEDDASAMIREDDYPALLE	PEDDASAMIREDDY PALLI
PEDIGUNDLAPALLE H.W.	PEDIGUNDLAPALLE & H.W.
KURAPALLE H.W.	KURAPALLE& HW
KONDATHIMMANAPALLI	KONDATHIMMANAPALLE
PEDDABOMMANAPALLE	PEDDABOMANAPALLI
SANTHIPURAM	SANTHURU
GOLLAPALLEDINNE	GOLLAPALII
SONNAGOWNNIPALLE	SONNEGOWNIPALLE
NAYANAPALLE	NAYANEPALLE
SIVARAMAPURAM	SIVARAMPURAM
KOTHIGUTTAPALLE	KOTHIGUTLAPALLI
BURADASIDDANIPALLE	BURADASIDDANAPALLI
JEEDIMANIPALLE	JEEDIMANUPALLE
SHESHADRIPURAM	SHESHAGRIPURAM
REDDIVARIPALLE	REDDIVARIPALLI
REGADADINNEPALLE	REGADADINNEPALLI
BELLAKOGILA	BELLAKOGILLA
GESIKAPALLE	GESIKAPALLI
SOLISETTIPALLE	SOLISETTIPALLI
KRISHNAPURAMDINNE	KRISHNAPURAM DINNE
KADAMANI VANKA	KADAMANIVANKA
PAMANA BOYANAPALLE	PAMABOYANAPALLE
P.M.K.THANDA	P.M.K THANDA
PALLAKUPPAM	PALLIKUPPAM
YANADHICOLONY	YANADHI COLONY
HARIJANAKOTA	HARIZANAKOTA
GEEDIMAKULAPALLE	GEEDIMAKULAPALLI
KUPPIGARIPALLE	KUPPIGANIPALLI
BATTUVARIPALLE	BATTAVARIPALLE
PEDDAGOPANAPALLE	PEDDAGOPPANAPALLI
YANADIPURAM	YANADHIPURAM
DURGA SAMUDRAM	DURGASAMUDRAM
PEDDANNAKOTALU	PEDDANAKOTTALU
JALAPPA KOTTALURU	JALAPPAKOTTALU
BANDASETTIALLE	BANDASETTIPALLE
THANJAMKOTTALU	THANJAMAKOTTALU
YANADIPALLE	YANADHIPALLE
PORAKUNTAPALLE	PORAKUNTLAPALLE
YANAMANASANAPALLE	YANAMANASANAPALLI
VANAGUTTAPALLE	VANAGUTAPALLI
KUNGEGOWNIYUR PART	KUNGEGOWNIYUR
BOMMAIPALLI-H.W	BOMMAIPALLI
LAKSHMI PURAM HC	LAKSHMIPURAM
MANGALAPALLI-H.W	MANGALAPALLI
YEGUVA YEDDULAVARIPALLI H.W	YEGUVA YEDDULAVARIPALLI
MEKALAGURAVAIAHPALLE	MEKALAGURAVAIAH PALLE
GUNDLAKATTAMANCHI-H.W	GUNDLAKATTAMANCHI(H.W)
KARIDIVARIPALLI H.W.	KARIDIVARIPALLI (H.W)
MUNGARAMADUGU-H.W COLNY	MUNGARAMADUGU(H.W)COLNY
PAPUDESIVARIKANDIGA H.W	PAPUDESIVARIKANDIGA &H.W
CHEEKURUPALLI-H.W	CHEEKURUPALLI
THUMBA KUPPAM-AAW	THUMBA KUPPAM
VELUTHURUCHENU CJFS	VELUTHUCHENU
KALLURU PALLI H.W	KALLURU PALLI
KUMMARAPALLI-H.W	KUMMARIPALLI
DAMARAKULA VODDU H.W	DAMARAKULA VODDU
MADUPOLURU H.W	MADU POLURU
Aggichenu palli ST	Aggichenupalli
Aggichenu palli ST	Aggichenupalli
VENGAREDDIPALLE	VENGAREDDYPALLI
UPPARAPALLE	UPPARAPALLI
MITTAVANDLAPALLI	MITTAVANDLAPALLLI
VADDIPALLE	VADDIPALLI
GANGIREDDYGARI PALLE	GANGIREDDYGARIPALLE


KOTHAVANDLAPALLE	KOTHAPALLE


KALLUANGADI	KALLUNGADI
VELLIGALLU	VELLILGALLU
MALIGIAVARIPALLE	MALIGIVARIPALLE
CHINTAMANUGUDA	CHINTALAGUDA
CHINTAMNUGUDA	CHINTAMANUGUDA